1111111111
1P000001E1
1001110001
1001000001
1001000111
1001000101
1001111101
100C0000C1
1111111111