11111
1PCE1
1CCC1
111C1
1CCC1
11111