11111111111
1P000000011
101100C1001
1E1C00010C1
11111111111