1111111111111111111111111111111111
1EC00T000000000C00000C000000000001
1C100101001000001010T1000000010101
1010010010101010001001000000010101
1P0000000C00C000000000000T000000C1
1111111111111111111111111111111111