11111111111111111111111111111111111111111
1C0000000C0000T11000000C00000000000T11111
1T000000000000011000000000000000T000000C1
100000000110T0011000000T000000T0000111011
10000000011T0110000000000P11110000C111011
10000000011001100000C000001111000000000T1
11000110011000000000000001111000000000001
11C011100000000000111C000T00C0000001000C1
11111110000T00000111000000000000000000001
1111C000000000001110000000011110000T00001
11110E000000000111C00000000111100000000C1
11111111111111111111111111111111111111111