1111111111
1P00C011E1
1001110001
10010000C1
1000000111
1001000101
1001111101
1000000001
1111111111