1111111111
1P00C001E1
1001110001
10010000C1
1001000111
1001000101
1001111101
1C00000001
1111111111