1111111111111111111
1000000C010000T0001
1000T00001000000001
1C000000010000E0001
1000001111C00000001
10T00000000000000C1
1000C00000001000001
10000000000010000P1
1111111111111111111