1111111111111111111
1000000C01000000001
1000000001000000001
1C000000010000000E1
1000001111C00000001
10000000000000000C1
1000C00000001000001
10000000000010000P1
1111111111111111111