1111111111111111111
1000000C010000T0001
1000T000010000C0001
1C00000001000CEC001
1000001111C000C0001
10T00000000000000C1
1000C00000001000001
10000000000010000P1
1111111111111111111